1111111111
1P1C010CC1
1010C10111
1000010C01
1111011101
1C01000001
10C001E001
1111111111