1111111111
1P1C0100C1
1011C10111
1000010C01
1111011101
1C01000001
10C0X1E0C1
1111111111