111111111111111111111
1P0000000000001C00001
100000000000001000001
10000000000C000000001
100000000X000E1000001
111111111111111111111