11111111111111
1P0010    0001
1111         1
1    1111    1
1  0C000E00001
11111111111111