11111111111111
1P001000000001
11111111111111
11111111111111
1000C000E00001
11111111111111