11111111111111
1P001000000001
10000000000000
10000000000001
1000C000E00001
11111111111111